version https://git-lfs.github.com/spec/v1
oid sha256:995a727234ede410280f89d9223219219422b70e45ccb86893457835dbda2f45
size 3924
